"filename", "language", "TypeScript", "CSS", "HTML", "comment", "blank", "total"
"c:\Users\dillo\Documents\probable-tribble\HAPPYLONELY-FRONTEND\src\main\frontend\src\app\admin\admin.component.css", "CSS", 0, 0, 0, 0, 1, 1
"c:\Users\dillo\Documents\probable-tribble\HAPPYLONELY-FRONTEND\src\main\frontend\src\app\admin\admin.component.html", "HTML", 0, 0, 70, 0, 4, 74
"c:\Users\dillo\Documents\probable-tribble\HAPPYLONELY-FRONTEND\src\main\frontend\src\app\admin\admin.component.spec.ts", "TypeScript", 17, 0, 0, 0, 5, 22
"c:\Users\dillo\Documents\probable-tribble\HAPPYLONELY-FRONTEND\src\main\frontend\src\app\admin\admin.component.ts", "TypeScript", 221, 0, 0, 0, 14, 235
"c:\Users\dillo\Documents\probable-tribble\HAPPYLONELY-FRONTEND\src\main\frontend\src\app\app-routing.module.ts", "TypeScript", 36, 0, 0, 0, 4, 40
"c:\Users\dillo\Documents\probable-tribble\HAPPYLONELY-FRONTEND\src\main\frontend\src\app\app.component.css", "CSS", 0, 3, 0, 1, 0, 4
"c:\Users\dillo\Documents\probable-tribble\HAPPYLONELY-FRONTEND\src\main\frontend\src\app\app.component.html", "HTML", 0, 0, 6, 0, 0, 6
"c:\Users\dillo\Documents\probable-tribble\HAPPYLONELY-FRONTEND\src\main\frontend\src\app\app.component.spec.ts", "TypeScript", 25, 0, 0, 0, 5, 30
"c:\Users\dillo\Documents\probable-tribble\HAPPYLONELY-FRONTEND\src\main\frontend\src\app\app.component.ts", "TypeScript", 15, 0, 0, 0, 2, 17
"c:\Users\dillo\Documents\probable-tribble\HAPPYLONELY-FRONTEND\src\main\frontend\src\app\app.module.ts", "TypeScript", 91, 0, 0, 0, 4, 95
"c:\Users\dillo\Documents\probable-tribble\HAPPYLONELY-FRONTEND\src\main\frontend\src\app\art\art.component.css", "CSS", 0, 39, 0, 0, 7, 46
"c:\Users\dillo\Documents\probable-tribble\HAPPYLONELY-FRONTEND\src\main\frontend\src\app\art\art.component.html", "HTML", 0, 0, 21, 0, 2, 23
"c:\Users\dillo\Documents\probable-tribble\HAPPYLONELY-FRONTEND\src\main\frontend\src\app\art\art.component.spec.ts", "TypeScript", 17, 0, 0, 0, 5, 22
"c:\Users\dillo\Documents\probable-tribble\HAPPYLONELY-FRONTEND\src\main\frontend\src\app\art\art.component.ts", "TypeScript", 121, 0, 0, 0, 5, 126
"c:\Users\dillo\Documents\probable-tribble\HAPPYLONELY-FRONTEND\src\main\frontend\src\app\auth.guard.spec.ts", "TypeScript", 18, 0, 0, 0, 5, 23
"c:\Users\dillo\Documents\probable-tribble\HAPPYLONELY-FRONTEND\src\main\frontend\src\app\auth.guard.ts", "TypeScript", 11, 0, 0, 0, 5, 16
"c:\Users\dillo\Documents\probable-tribble\HAPPYLONELY-FRONTEND\src\main\frontend\src\app\common\service\auth.service.ts", "TypeScript", 21, 0, 0, 0, 3, 24
"c:\Users\dillo\Documents\probable-tribble\HAPPYLONELY-FRONTEND\src\main\frontend\src\app\common\service\forum.service.ts", "TypeScript", 42, 0, 0, 0, 4, 46
"c:\Users\dillo\Documents\probable-tribble\HAPPYLONELY-FRONTEND\src\main\frontend\src\app\common\service\userservice.ts", "TypeScript", 60, 0, 0, 0, 10, 70
"c:\Users\dillo\Documents\probable-tribble\HAPPYLONELY-FRONTEND\src\main\frontend\src\app\email\email.component.css", "CSS", 0, 0, 0, 0, 1, 1
"c:\Users\dillo\Documents\probable-tribble\HAPPYLONELY-FRONTEND\src\main\frontend\src\app\email\email.component.html", "HTML", 0, 0, 1, 0, 1, 2
"c:\Users\dillo\Documents\probable-tribble\HAPPYLONELY-FRONTEND\src\main\frontend\src\app\email\email.component.spec.ts", "TypeScript", 18, 0, 0, 0, 6, 24
"c:\Users\dillo\Documents\probable-tribble\HAPPYLONELY-FRONTEND\src\main\frontend\src\app\email\email.component.ts", "TypeScript", 10, 0, 0, 0, 3, 13
"c:\Users\dillo\Documents\probable-tribble\HAPPYLONELY-FRONTEND\src\main\frontend\src\app\email\email.service.ts", "TypeScript", 19, 0, 0, 0, 2, 21
"c:\Users\dillo\Documents\probable-tribble\HAPPYLONELY-FRONTEND\src\main\frontend\src\app\email\emailRequest.ts", "TypeScript", 8, 0, 0, 0, 1, 9
"c:\Users\dillo\Documents\probable-tribble\HAPPYLONELY-FRONTEND\src\main\frontend\src\app\environments\environment.ts", "TypeScript", 4, 0, 0, 0, 0, 4
"c:\Users\dillo\Documents\probable-tribble\HAPPYLONELY-FRONTEND\src\main\frontend\src\app\header\header.component.css", "CSS", 0, 36, 0, 0, 6, 42
"c:\Users\dillo\Documents\probable-tribble\HAPPYLONELY-FRONTEND\src\main\frontend\src\app\header\header.component.html", "HTML", 0, 0, 3, 0, 0, 3
"c:\Users\dillo\Documents\probable-tribble\HAPPYLONELY-FRONTEND\src\main\frontend\src\app\header\header.component.spec.ts", "TypeScript", 17, 0, 0, 0, 5, 22
"c:\Users\dillo\Documents\probable-tribble\HAPPYLONELY-FRONTEND\src\main\frontend\src\app\header\header.component.ts", "TypeScript", 46, 0, 0, 0, 5, 51
"c:\Users\dillo\Documents\probable-tribble\HAPPYLONELY-FRONTEND\src\main\frontend\src\app\home\canvas-toBlob.d.ts", "TypeScript", 1, 0, 0, 0, 1, 2
"c:\Users\dillo\Documents\probable-tribble\HAPPYLONELY-FRONTEND\src\main\frontend\src\app\home\chat.service.ts", "TypeScript", 62, 0, 0, 2, 9, 73
"c:\Users\dillo\Documents\probable-tribble\HAPPYLONELY-FRONTEND\src\main\frontend\src\app\home\hluser.ts", "TypeScript", 7, 0, 0, 0, 2, 9
"c:\Users\dillo\Documents\probable-tribble\HAPPYLONELY-FRONTEND\src\main\frontend\src\app\home\home.component.css", "CSS", 0, 141, 0, 0, 25, 166
"c:\Users\dillo\Documents\probable-tribble\HAPPYLONELY-FRONTEND\src\main\frontend\src\app\home\home.component.html", "HTML", 0, 0, 78, 5, 7, 90
"c:\Users\dillo\Documents\probable-tribble\HAPPYLONELY-FRONTEND\src\main\frontend\src\app\home\home.component.spec.ts", "TypeScript", 17, 0, 0, 0, 5, 22
"c:\Users\dillo\Documents\probable-tribble\HAPPYLONELY-FRONTEND\src\main\frontend\src\app\home\home.component.ts", "TypeScript", 238, 0, 0, 47, 24, 309
"c:\Users\dillo\Documents\probable-tribble\HAPPYLONELY-FRONTEND\src\main\frontend\src\app\home\message.ts", "TypeScript", 24, 0, 0, 1, 6, 31
"c:\Users\dillo\Documents\probable-tribble\HAPPYLONELY-FRONTEND\src\main\frontend\src\app\login\LoginRequest.ts", "TypeScript", 5, 0, 0, 0, 0, 5
"c:\Users\dillo\Documents\probable-tribble\HAPPYLONELY-FRONTEND\src\main\frontend\src\app\login\login.component.css", "CSS", 0, 61, 0, 0, 11, 72
"c:\Users\dillo\Documents\probable-tribble\HAPPYLONELY-FRONTEND\src\main\frontend\src\app\login\login.component.html", "HTML", 0, 0, 32, 0, 0, 32
"c:\Users\dillo\Documents\probable-tribble\HAPPYLONELY-FRONTEND\src\main\frontend\src\app\login\login.component.spec.ts", "TypeScript", 17, 0, 0, 0, 5, 22
"c:\Users\dillo\Documents\probable-tribble\HAPPYLONELY-FRONTEND\src\main\frontend\src\app\login\login.component.ts", "TypeScript", 43, 0, 0, 1, 3, 47
"c:\Users\dillo\Documents\probable-tribble\HAPPYLONELY-FRONTEND\src\main\frontend\src\app\register\RegisterRequest.ts", "TypeScript", 5, 0, 0, 0, 0, 5
"c:\Users\dillo\Documents\probable-tribble\HAPPYLONELY-FRONTEND\src\main\frontend\src\app\register\register.component.css", "CSS", 0, 51, 0, 0, 11, 62
"c:\Users\dillo\Documents\probable-tribble\HAPPYLONELY-FRONTEND\src\main\frontend\src\app\register\register.component.html", "HTML", 0, 0, 48, 0, 0, 48
"c:\Users\dillo\Documents\probable-tribble\HAPPYLONELY-FRONTEND\src\main\frontend\src\app\register\register.component.spec.ts", "TypeScript", 17, 0, 0, 0, 5, 22
"c:\Users\dillo\Documents\probable-tribble\HAPPYLONELY-FRONTEND\src\main\frontend\src\app\register\register.component.ts", "TypeScript", 55, 0, 0, 0, 6, 61
"c:\Users\dillo\Documents\probable-tribble\HAPPYLONELY-FRONTEND\src\main\frontend\src\app\shop\objects\product.ts", "TypeScript", 9, 0, 0, 0, 0, 9
"c:\Users\dillo\Documents\probable-tribble\HAPPYLONELY-FRONTEND\src\main\frontend\src\app\shop\product\product.service.spec.ts", "TypeScript", 12, 0, 0, 0, 5, 17
"c:\Users\dillo\Documents\probable-tribble\HAPPYLONELY-FRONTEND\src\main\frontend\src\app\shop\product\product.service.ts", "TypeScript", 28, 0, 0, 0, 7, 35
"c:\Users\dillo\Documents\probable-tribble\HAPPYLONELY-FRONTEND\src\main\frontend\src\app\shop\shop.component.css", "CSS", 0, 52, 0, 0, 10, 62
"c:\Users\dillo\Documents\probable-tribble\HAPPYLONELY-FRONTEND\src\main\frontend\src\app\shop\shop.component.html", "HTML", 0, 0, 30, 1, 1, 32
"c:\Users\dillo\Documents\probable-tribble\HAPPYLONELY-FRONTEND\src\main\frontend\src\app\shop\shop.component.spec.ts", "TypeScript", 44, 0, 0, 0, 9, 53
"c:\Users\dillo\Documents\probable-tribble\HAPPYLONELY-FRONTEND\src\main\frontend\src\app\shop\shop.component.ts", "TypeScript", 83, 0, 0, 0, 10, 93
"c:\Users\dillo\Documents\probable-tribble\HAPPYLONELY-FRONTEND\src\main\frontend\src\app\thread-create\thread-create.component.css", "CSS", 0, 31, 0, 0, 6, 37
"c:\Users\dillo\Documents\probable-tribble\HAPPYLONELY-FRONTEND\src\main\frontend\src\app\thread-create\thread-create.component.html", "HTML", 0, 0, 27, 0, 0, 27
"c:\Users\dillo\Documents\probable-tribble\HAPPYLONELY-FRONTEND\src\main\frontend\src\app\thread-create\thread-create.component.spec.ts", "TypeScript", 17, 0, 0, 0, 5, 22
"c:\Users\dillo\Documents\probable-tribble\HAPPYLONELY-FRONTEND\src\main\frontend\src\app\thread-create\thread-create.component.ts", "TypeScript", 49, 0, 0, 2, 8, 59
"c:\Users\dillo\Documents\probable-tribble\HAPPYLONELY-FRONTEND\src\main\frontend\src\app\thread-detail\thread-detail.component.css", "CSS", 0, 73, 0, 0, 15, 88
"c:\Users\dillo\Documents\probable-tribble\HAPPYLONELY-FRONTEND\src\main\frontend\src\app\thread-detail\thread-detail.component.html", "HTML", 0, 0, 33, 0, 0, 33
"c:\Users\dillo\Documents\probable-tribble\HAPPYLONELY-FRONTEND\src\main\frontend\src\app\thread-detail\thread-detail.component.spec.ts", "TypeScript", 17, 0, 0, 0, 5, 22
"c:\Users\dillo\Documents\probable-tribble\HAPPYLONELY-FRONTEND\src\main\frontend\src\app\thread-detail\thread-detail.component.ts", "TypeScript", 101, 0, 0, 0, 6, 107
"c:\Users\dillo\Documents\probable-tribble\HAPPYLONELY-FRONTEND\src\main\frontend\src\app\thread-list\thread-list.component.css", "CSS", 0, 65, 0, 0, 11, 76
"c:\Users\dillo\Documents\probable-tribble\HAPPYLONELY-FRONTEND\src\main\frontend\src\app\thread-list\thread-list.component.html", "HTML", 0, 0, 37, 0, 2, 39
"c:\Users\dillo\Documents\probable-tribble\HAPPYLONELY-FRONTEND\src\main\frontend\src\app\thread-list\thread-list.component.spec.ts", "TypeScript", 17, 0, 0, 0, 5, 22
"c:\Users\dillo\Documents\probable-tribble\HAPPYLONELY-FRONTEND\src\main\frontend\src\app\thread-list\thread-list.component.ts", "TypeScript", 31, 0, 0, 0, 6, 37
"c:\Users\dillo\Documents\probable-tribble\HAPPYLONELY-FRONTEND\src\main\frontend\src\app\user\user.component.css", "CSS", 0, 0, 0, 0, 1, 1
"c:\Users\dillo\Documents\probable-tribble\HAPPYLONELY-FRONTEND\src\main\frontend\src\app\user\user.component.html", "HTML", 0, 0, 18, 4, 3, 25
"c:\Users\dillo\Documents\probable-tribble\HAPPYLONELY-FRONTEND\src\main\frontend\src\app\user\user.component.spec.ts", "TypeScript", 17, 0, 0, 0, 5, 22
"c:\Users\dillo\Documents\probable-tribble\HAPPYLONELY-FRONTEND\src\main\frontend\src\app\user\user.component.ts", "TypeScript", 84, 0, 0, 0, 3, 87
"c:\Users\dillo\Documents\probable-tribble\HAPPYLONELY-FRONTEND\src\main\frontend\src\app\youtube-dl\download.service.ts", "TypeScript", 13, 0, 0, 0, 2, 15
"c:\Users\dillo\Documents\probable-tribble\HAPPYLONELY-FRONTEND\src\main\frontend\src\app\youtube-dl\youtube-dl.component.css", "CSS", 0, 21, 0, 0, 4, 25
"c:\Users\dillo\Documents\probable-tribble\HAPPYLONELY-FRONTEND\src\main\frontend\src\app\youtube-dl\youtube-dl.component.html", "HTML", 0, 0, 20, 4, 1, 25
"c:\Users\dillo\Documents\probable-tribble\HAPPYLONELY-FRONTEND\src\main\frontend\src\app\youtube-dl\youtube-dl.component.spec.ts", "TypeScript", 17, 0, 0, 0, 5, 22
"c:\Users\dillo\Documents\probable-tribble\HAPPYLONELY-FRONTEND\src\main\frontend\src\app\youtube-dl\youtube-dl.component.ts", "TypeScript", 38, 0, 0, 0, 6, 44
"c:\Users\dillo\Documents\probable-tribble\HAPPYLONELY-FRONTEND\src\main\frontend\src\index.html", "HTML", 0, 0, 16, 1, 3, 20
"c:\Users\dillo\Documents\probable-tribble\HAPPYLONELY-FRONTEND\src\main\frontend\src\main.ts", "TypeScript", 4, 0, 0, 0, 4, 8
"c:\Users\dillo\Documents\probable-tribble\HAPPYLONELY-FRONTEND\src\main\frontend\src\polyfills.ts", "TypeScript", 1, 0, 0, 0, 1, 2
"c:\Users\dillo\Documents\probable-tribble\HAPPYLONELY-FRONTEND\src\main\frontend\src\styles.css", "CSS", 0, 35, 0, 1, 20, 56
"c:\Users\dillo\Documents\probable-tribble\HAPPYLONELY-FRONTEND\src\main\frontend\src\window-global-fix.ts", "TypeScript", 4, 0, 0, 0, 0, 4
"Total", "-", 1894, 608, 440, 70, 404, 3416